All Eyes on Me - Bo Burnham
Affection - Between Friends
Lado vazio do Sofa - Rodrigo Alarcon (a versão do Youtube)
Don't Wait - Mapel
Bitter Sweet Symphony - The Verve
One Way Trip to the Sun - Ditch
It Wasn't Me - Shaggy, rik rok
Buttercup - Jack Stauber
Crazy - Gnarls Barkley
Far Away - José González
Burn the Witch - Shawn James
Blade Runner 2049 - Synthwave Goose
Running With The Wolves - Aurora
Army Of Me - Björk
Hey Now - london Grammar
Smells Blood - Kensuke Ushio
Brave New World - Kalandra
Eivør - Trøllabundin
Bloom - J^p^n
踊り子 - Vaundy
I Love You - Wookid
Leaving On A Jet Plane - Chantal Kreviazuk
Hatsune Miku - Oblivion
Humanity - Max Brhon
Virus - Klound
I hate Everything Abaout You - Three Days Grace
Mr Highway's Thinking Abaout the End - A day To Remenber
Chaos Lives In Everything - Korn
I Am the Warlock - Probot, jack Black
oh mama - - run the jewels
black skinhead - kanye west
enemy - imagine dragons
you're so cool - jonathan bree